**************************************************
*   *       *               *  * * * * **    *   *
*** *  *  **** ***** * ***       *     *  * ** * *
s * * ***   *  * *   * * ****** **** * * **  * * *
* * * * *      * *** *   **    **      *  ** *** *
*   *   *   *  *       * *   *  *  * * ** *   *  *
*** *** ***** ******** *    *** ** * * *  * **** *
*                  *   *  *  *     * *   **      *
*   *       *               *  * * * * **    *   *
*** *  *  **** ***** * ***       *     *  * ** * *
* * * ***   *  * *   * * ****** **** * * **  * * *
* * * * *      * *** *   **    **      *  ** *** *
*                  *   *  *        * *   **      *
****************************************e*********
