**************************************************
*   *       *               *  * * * * **    *   *
*** *  *  **** ***** * ***       *     *  * ** * *
s * * ***   *  * *   * * ****** **** * * **  * * *
* * * * *      * *** *   **    **      *  ** *** *
*   *   *   *  *       * *   *  *  * * ** *   *  *
*  *  *** * *  *   ***** **** **   *          *  *
*       *     ***             *       *  ***     *
***** ********************************************
*   *       *      * *      *  * * * * **    *   *
*** *  *  **** ***** * ***  *    *     *  * ** * *
* * * ***   *  * *   * * ****** **** * * **  * * *
* * * * *      * *** *   **    **      *  ** *** *
*   *   *   *  *       * *   *  *  * * ** *   *  *
*** *** ***** ******** *    *** ** * * *  * **** *
*          *           *  *  *     * *   **      *
************* ************************** *********
*         *      *          *   **   * *         *
********* *  *   * *  ***** * *  * *   * * *   * *
*  *    * * **** * *  *  *  * *  * *** ********* *
*  *  *** * *  *   ***** **** **   *          *  *
*       *     ***             *       *  ***     *
*   *       *      * *      *  * * * * **    *   *
*** *  *  **** ***** * ***  *    *     *  * ** * *
* * * ***   *  * *   * * ****** **** * * **  * * *
* * * * *      * *** *   **    **      *  ** *** *
*   *   *   *  *       * *   *  *  * * ** *   *  *
*** *** ***** ******** *    *** ** * * *  * **** *
*          *       *   *  *  *     * *   **      *
**************************************** *********
*         *      *          *   **   * *         *
* ******* *  *   * *  ***** * *  * *   * * *   * *
*  *    * * **** * *  *  *  * *  * *** ********* *
*  *  *** * *  *   ***** **** **   *          *  *
*       *     ***             *       *  ***     *
****** *******************************************
*   *       *      * *      *  * * * * **    *   *
*** *  *  **** ***** * ***  *    *     *  * ** * *
* * * ***   *  * *   * * ****** **** * * **  * * *
* * * * *      * *** *   **    **      *  ** *** *
*   *   *   *  *       * *   *  *  * * ** *   *  *
*** *** ***** ******** *    *** ** * * *  * **** *
*          *           *  *  *     * *   **      *
**************************************** *********
*         *      *          *   **   * *         *
* ******* *  *   * *  ***** * *  * *   * * *   * *
*  *    * * ** * * *  *  *  * *  * *** ********* *
*  *  *** * *  *   ***** **** **   *          *  *
*       *     ***             *       *  ***     *
**************************************** *********
*         *      *          *   **   * *         *
* ******* *  *   * *  ***** * *  * *   * * *   * *
*  *    * ****** * *  *  *  * *  * *** ********* *
*  *  *** * *      ***** **** **   *          *  *
*       *     ***             *       *  ***     *
***** ********************************************
*   *       *      * *      *  * * * * **    *   *
*** *  *  **** ***** * ***  *    *     *  * ** * *
* * * ***   *  * *   * * ****** **** * * **  * * *
* * * * *      * *** *   **    **      *  ** *** *
*   *   *   *  *       * *   *  *  * * ** *   *  *
*** *** ***** ******** *    *** ** * * *  * **** *
*          *           *  *  *     * *   **      *
**************************************** *********
*         *      *          *   **   * *         *
********* *  *   * *  ***** * *  * *   * * *   * *
*  *    * * **** * *  *  *  * *  * *** ********* *
*  *  *** * *  *   ***** **** **   *          *  *
*       *     ***             *       *  ***     *
*   *       *      * *      *  * * * * **    *   *
*** *  *  **** ***** * ***  *    *     *  * ** * *
* * * ***   *  * *   * * ****** **** * * **  * * *
* * * * *      * *** *   **    **      *  ** *** *
*   *   *   *  *       * *   *  *  * * ** *   *  *
*** *** ***** ******** *    *** ** * * *  * **** *
*          *       *   *  *  *     * *   **      *
**************************************** *********
*         *      *          *   **   * *         *
* ******* *  *   * *  ***** * *  * *   * * *   * *
*  *    * * **** * *  *  *  * *  * *** ********* *
*  *  *** * *  *   ***** **** **   *          *  *
*       *     ***             *       *  ***     *
****** *******************************************
*   *       *      * *      *  * * * * **    *   *
*** *  *  **** ***** * ***  *    *     *  * ** * *
* * * ***   *  * *   * * ****** **** * * **  * * *
* * * * *      * *** *   **    **      *  ** *** *
*   *   *   *  *       * *   *  *  * * ** *   *  *
*** *** ***** ******** *    *** ** * * *  * **** *
*          *           *  *  *     * *   **      *
**************************************** *********
*         *      *          *   **   * *         *
* ******* *  *   * *  ***** * *  * *   * * *   * *
*  *    * * **** * *  *  *  * *  * *** ********* *
*  *  *** * *  *   ***** **** **   *          *  *
*       *     ***             *       *  ***     *
*   *       *               *  * * * * **    *   *
*** *  *  **** ***** * ***       *     *  * ** * *
* * * ***   *  * *   * * ****** **** * * **  * * *
* * * * *      * *** *   **    **      *  ** *** *
*   *   *   *  *       * *   *  *  * * ** *   *  *
*** *** ***** ******** *    *** ** * * *  * **** *
*                  *   *  *  *     * *   **      *
**************************************** *********
*         *      *          *   **   * *         *
* ******* *  *   * *  ***** * *  * *   * * *   * *
*  *    * * **** * *  *  *  * *  * *** ********* *
*  *  *** * *  *   ***** **** **   *          *  *
*       *     ***             *       *  ***     *
***** ********************************************
*   *       *      * *      *  * * * * **    *   *
*** *  *  **** ***** * ***  *    *     *  * ** * *
* * * ***   *  * *   * * ****** **** * * **  * * *
* * * * *      * *** *   **    **      *  ** *** *
*   *   *   *  *       * *   *  *  * * ** *   *  *
*** *** ***** ******** *    *** ** * * *  * **** *
*          *           *  *  *     * *   **      *
**************************************** *********
*         *      *          *   **   * *         *
********* *  *   * *  ***** * *  * *   * * *   * *
*  *    * * **** * *  *  *  * *  * *** ********* *
*  *  *** * *  *   ***** **** **   *          *  *
*       *     ***             *       *  ***     *
*   *       *      * *      *  * * * * **    *   *
*** *  *  **** ***** * ***  *    *     *  * ** * *
* * * ***   *  * *   * * ****** **** * * **  * * *
* * * * *      * *** *   **    **      *  ** *** *
*   *   *   *  *       * *   *  *  * * ** *   *  *
*** *** ***** ******** *    *** ** * * *  * **** *
*          *       *   *  *  *     * *   **      *
**************************************** *********
*         *      *          *   **   * *         *
* ******* *  *   * *  ***** * *  * *   * * *   * *
*  *    * * **** * *  *  *  * *  * *** ********* *
*  *  *** * *  *   ***** **** **   *          *  *
*       *     ***             *       *  ***     *
****** *******************************************
*   *       *      * *      *  * * * * **    *   *
*** *  *  **** ***** * ***  *    *     *  * ** * *
* * * ***   *  * *   * * ****** **** * * **  * * *
* * * * *      * *** *   **    **      *  ** *** *
*   *   *   *  *       * *   *  *  * * ** *   *  *
*** *** ***** ******** *    *** ** * * *  * **** *
*          *           *  *  *     * *   **      *
**************************************** *********
*         *      *          *   **   * *         *
* ******* *  *   * *  ***** * *  * *   * * *   * *
*  *    * * **** * *  *  *  * *  * *** ********* *
*  *  *** * *  *   ***** **** **   *          *  *
*       *     ***             *       *  ***     *
*e************************************************
